W	W	W	W	W	W	W	W	W	W	W	W	W	W	W	W	W	W	W	W	W	W	W	W	W	W	W	W	W	W	W	W
W	P	P	P	P	W	P	P	P	P	P	P	P	W	P	P	P	P	W	P	P	P	P	P	P	P	P	P	P	P	P	W
W	P	W	W	P	P	P	W	W	P	W	W	P	P	P	W	W	P	P	P	W	W	P	W	W	W	W	W	P	W	P	W
W	P	W	W	W	P	W	W	W	P	P	P	P	W	W	W	W	W	W	P	P	P	P	W	P	P	P	W	P	W	P	W
W	P	P	P	P	P	P	P	P	P	W	W	P	W	W	W	W	W	W	P	W	W	P	W	P	W	P	W	P	W	P	W
W	P	W	W	W	P	W	W	W	P	W	W	P	P	P	P	P	P	P	P	W	W	P	W	P	W	S	W	P	W	P	W
W	P	W	W	W	P	W	W	W	P	W	W	P	W	W	W	W	W	W	P	W	W	P	W	P	W	W	W	P	W	P	W
W	P	W	W	W	P	W	W	W	P	W	W	P	P	P	P	P	P	P	P	W	W	P	W	P	P	P	P	P	W	P	W
W	P	P	P	P	P	P	P	P	P	W	W	P	W	P	W	W	P	W	P	W	W	P	W	W	W	W	W	W	W	P	W
W	P	W	W	W	P	W	W	W	P	P	P	P	W	P	W	W	P	W	P	P	P	P	P	P	P	P	P	P	P	P	W
W	P	W	W	W	P	W	W	W	P	W	W	W	W	P	W	W	P	W	W	W	W	P	W	W	W	W	P	W	W	P	W
W	P	W	W	W	P	W	W	W	P	W	E	E	E	E	E	E	E	E	E	E	W	P	W	W	W	W	P	W	W	P	W
W	P	P	P	P	P	P	P	P	P	P	E	W	W	W	H	H	W	W	W	E	P	P	P	P	P	P	P	P	P	P	W
W	W	W	W	W	P	W	W	W	P	W	E	W	G	G	G	G	G	G	W	E	W	P	W	W	W	P	W	W	W	W	W
E	E	E	E	E	P	W	W	W	P	W	E	W	G	G	G	G	G	G	W	E	W	P	W	W	W	P	E	E	E	E	E
W	W	W	W	W	P	W	W	W	P	W	E	W	G	G	G	G	G	G	W	E	W	P	W	W	W	P	W	W	W	W	W
W	P	P	P	P	P	P	P	P	P	W	E	W	W	W	W	W	W	W	W	E	W	P	P	P	P	P	P	P	P	P	W
W	P	W	W	W	P	W	W	W	P	P	E	E	E	E	X   X	E	E	E	E	P	P	W	W	W	W	P	W	W	P	W
W	P	W	W	W	P	W	W	W	P	W	W	W	W	P	W	W	P	W	W	W	W	P	W	W	W	W	P	W	W	P	W
W	P	P	P	P	P	P	P	P	P	W	W	W	W	P	W	W	P	W	W	W	W	P	P	P	P	P	P	W	W	P	W
W	P	W	W	P	W	W	W	W	P	P	P	P	P	P	P	P	P	P	P	P	P	P	W	W	P	W	P	W	W	P	W
W	P	W	W	P	W	W	W	W	P	W	W	W	W	P	W	W	P	W	W	W	W	P	W	W	P	P	P	P	P	P	W
W	P	P	P	P	P	P	P	P	P	W	E	E	W	P	P	P	P	W	E	E	W	P	W	W	P	W	W	W	W	P	W
W	P	W	W	W	W	W	W	W	P	W	E	E	W	P	W	W	P	W	E	E	W	P	W	W	P	W	W	W	W	P	W
W	P	W	P	P	P	P	P	W	P	W	W	W	W	P	W	W	P	W	W	W	W	P	P	P	P	P	P	P	P	P	W
W	P	W	P	W	W	W	P	W	P	P	P	P	P	P	P	P	P	P	P	P	P	P	W	P	W	P	W	P	W	P	W
W	P	W	P	W	S	W	P	W	P	W	P	W	W	W	W	W	W	W	W	P	W	P	W	P	W	P	P	P	W	P	W
W	P	W	P	W	P	W	P	W	P	W	P	W	E	E	E	E	E	E	W	P	W	P	W	P	P	P	W	P	W	P	W
W	P	W	P	W	P	P	P	W	P	W	P	W	E	E	E	E	E	E	W	P	W	P	W	P	W	P	P	P	W	P	W
W	P	W	P	W	W	W	W	W	P	P	P	P	W	W	W	W	W	W	P	P	P	P	W	P	W	P	W	P	W	P	W
W	P	P	P	P	P	P	P	P	P	W	W	P	P	P	P	P	P	P	P	W	W	P	P	P	P	P	P	P	P	P	W
W	W	W	W	W	W	W	W	W	W	W	W	W	W	W	W	W	W	W	W	W	W	W	W	W	W	W	W	W	W	W	W